WE ./textures/west.xpm  	    	   		
SO ./textures/south.xpm
EA ./textures/east.xpm
NO ./textures/north.xpm

C 143, 208, 242
F 255,229,204

        1111111111111111111111111
        1000000000001000000000001
        1000111000000100000010001
111111111000D0D0000000000000000001
1111011111001110001110000100000001
1N00000000011000001110000000111111
11110111111111011100000010001
11110111111111011101010010001
11000000110111011100000000001
100000X0000X000000000000100001
100000000000000000000000000001
110000011101010111110000001001
 11110111 1110101 1011110111111
 11111111 1111111 111111111111