
WE ./textures/west.xpm  	    	   		
SO ./textures/south.xpm
EA ./textures/east.xpm
NO ./textures/north.xpm


                    F                              220, 100,                         0                    
                   C                 225    ,    30   ,  255                    



1111111111111111111111111
10000000001100000000011
1111000001110000000000011
10010000000000000000000011111111
111111111011000001110000000001111
11110111111111011100000010001
11110111111111011101010010001
11000000110101011100000010001
10000000000000001100000010001
1000000000000000110101001N001
11000001110101011111011110001
11110111 1110101 101111010001
11111111111111111111111111111