WE ./textures/west.xpm
SO ./textures/south.xpm
EA ./textures/east.xpm
NO ./textures/north.xpm

C 196,220,245
F 228,210,184

1111111111111111111111111111111
1000000000000000000000000000001
1000111110000001111100000000001
100010001000D001000100011110001
1000100010000001000100001000001
1000100010111111000100001000001
1000000010100000100000001000001
101111101010XXX0101111101111001
1010000010100000101000000001001
1000N00010100000101000000001001
1010000010100000101000000001001
1011111010111111101111111011001
1000000010000000000000001000001
1000000000000000000000000000001
1111111111111111111111111111111
