WE ./textures/west.xpm
SO ./textures/south.xpm
EA ./textures/east.xpm
NO ./textures/north.xpm

C 198,222,246
F 232,214,188

111111111111111111111111111111111
100000000000000000000000000000001
100001111110000001111110000000001
100001000010000001000010000000001
1000010N0010000001000010000000001
100001000010000001000010000000001
100001111110000001111110000111101
100000000000000000000000000100001
101111111111011111111111110100001
101000000001011111000000001010001
10100000000101XXX10D000001010001
10100000000101XXX101111101010001
100000000000010000100000000100001
100000000000000000000000000000001
111111111111111111111111111111111
