WE ./textures/west.xpm
SO ./textures/south.xpm
EA ./textures/east.xpm
NO ./textures/north.xpm

C 180,210,240
F 220,205,185

11111111111111111111111111111
10000000000000000000000000001
10111111111101111111111111001
10100000000101000000000001001
1010N000000101000000000001001
101000000001010111111110001001
101011111101010100000010001001
10101000010D010101XXX01001001
101010000101010101XXX01001001
10101111110101010D00001001001
10100000000101010100001001001
10100000000100000100000001001
10111111111111111111111111001
10000000000000000000000000001
11111111111111111111111111111
