WE ./textures/west.xpm  	    	   		
SO ./textures/south.xpm
EA ./textures/east.xpm
NO ./textures/north.xpm
F 0,+0,0
C 255,+255,255


11111111
11111111
10N11111
11111111